10
10
7
7
......#...
....##.#..
#.........
...####...
...#..#..#
#..#..#...
..........
.........#
####..####
..........