15
15
10
10
.##.....#.#....
..#.....#.#....
..####..#......
...............
.....#....##...
.#...#...###...
..#.......#..#.
...#......####.
....#..........
...............
.##....#####..#
..............#
..##.....#....#
..##...####...#
.......#.......